.  .  .  .  .
.  W     W  .
G  W  P  W  G
.  W     W  .
.  .  .  .  .